1 1 1 1 1 1 1 1 1 1 1 1 
1 0 0 0 0 0 0 0 0 0 1 1 
1 0 0 0 0 0 0 0 0 0 1 1 
1 0 0 0 0 0 0 0 0 0 1 1 
1 0 0 0 0 0 0 0 0 0 1 1 
1 0 0 0 0 0 0 0 0 0 1 1 
1 0 0 0 0 0 0 5 0 0 1 1 
1 0 0 0 0 0 0 0 0 0 1 1 
1 0 0 0 0 0 0 0 0 0 1 1 
1 0 0 0 0 0 0 0 0 0 1 1 
1 0 0 0 0 0 0 1 0 0 1 1 
1 0 0 0 0 0 0 1 0 0 1 1 
1 0 0 0 5 0 0 1 0 0 1 1 
1 0 0 0 0 0 0 1 0 0 1 1 
1 0 0 0 0 0 0 1 0 2 1 1 
1 0 0 0 0 0 0 0 0 0 1 1 
1 0 0 0 0 0 0 0 0 0 1 1 
1 0 0 0 0 0 0 0 0 1 1 1 
1 0 0 0 0 0 0 0 0 0 3 1 
1 0 0 0 0 0 0 1 1 1 1 1 
1 0 0 0 0 0 0 0 0 5 1 1 
1 0 0 0 0 5 0 0 0 2 1 1 
1 0 0 0 0 0 0 0 0 6 1 1 
1 0 0 0 0 0 0 1 1 1 1 1 
1 0 0 0 0 0 0 0 0 0 3 1 
1 0 0 0 0 0 0 0 0 1 1 1 
1 0 0 0 0 0 0 0 0 0 1 1 
1 0 0 0 0 0 5 0 0 2 1 1 
1 0 0 0 0 0 0 0 0 0 1 1 
1 0 0 0 0 0 0 0 0 0 1 1 
1 0 0 0 0 0 0 0 0 5 1 1 
1 0 0 0 0 0 0 0 0 0 1 1 
1 0 0 0 0 0 0 0 0 0 1 1 
1 0 0 0 0 0 5 0 0 2 1 1 
1 0 0 0 0 0 0 0 0 0 1 1 
1 0 0 0 0 0 0 0 0 1 1 1 
1 0 0 0 0 0 0 0 0 0 1 1 
1 0 0 0 0 0 0 0 0 0 1 1 
1 0 0 0 0 0 0 0 0 0 1 1 
1 0 0 0 0 0 0 0 0 0 1 1 
1 0 0 4 0 0 4 0 0 4 1 1 
1 0 0 0 0 0 0 0 0 0 1 1 
1 0 0 0 0 0 0 0 0 0 1 1 
1 0 0 0 0 0 0 0 0 0 1 1 
1 0 0 0 0 0 0 0 0 0 3 1 
1 0 0 0 0 0 0 0 0 0 3 1 
1 0 0 0 0 0 5 0 0 0 3 1 
1 0 0 0 0 0 0 0 0 0 3 1 
1 0 0 0 0 0 0 0 0 0 3 1 
1 0 0 0 0 0 0 0 0 1 1 1 
1 0 0 0 0 0 0 5 0 0 1 1 
1 0 0 0 0 0 0 0 0 0 3 1 
1 0 0 0 0 5 0 0 0 0 3 1 
1 0 0 0 0 0 0 0 0 0 3 1 
1 0 0 0 0 0 1 0 0 0 1 1 
1 0 0 0 0 0 0 0 0 6 1 1 
1 0 0 0 0 0 0 0 0 0 1 1 
1 0 0 0 0 0 1 1 1 1 1 1 
1 0 0 0 0 0 0 0 0 5 1 1 
1 0 0 4 0 0 0 0 0 0 1 1 
1 0 0 0 0 0 0 0 0 0 1 1 
1 0 0 4 0 0 0 0 0 2 1 1 
1 0 0 0 0 0 0 5 0 0 1 1 
1 0 0 4 0 0 0 0 0 0 1 1 
1 0 0 0 0 0 0 0 0 2 1 1 
1 0 0 4 0 0 0 0 0 0 1 1 
1 0 0 0 0 0 0 5 0 0 1 1 
1 0 0 4 0 0 0 0 0 2 1 1 
1 0 0 0 0 0 0 0 0 0 1 1 
1 0 0 4 0 0 0 0 0 0 1 1 
1 0 0 0 0 0 0 0 0 5 1 1 
1 0 0 4 0 0 0 1 1 1 1 1 
1 0 0 0 0 0 0 0 0 0 1 1 
1 0 0 4 0 5 0 0 0 0 3 1 
1 0 0 0 0 0 0 0 0 0 3 1 
1 0 0 0 5 0 0 0 0 0 3 1 
1 0 0 0 0 0 0 0 0 0 3 1 
1 0 0 0 0 0 5 0 0 0 3 1 
1 0 0 0 0 0 0 0 1 1 1 1 
1 0 0 0 0 0 0 0 1 1 1 1 
1 0 0 0 0 0 0 0 0 0 3 1 
1 0 0 0 0 0 5 0 0 0 3 1 
1 0 0 0 0 0 0 0 0 0 3 1 
1 0 0 0 0 5 0 0 0 0 3 1 
1 0 0 0 0 0 0 0 0 0 3 1 
1 0 0 0 0 0 0 1 1 1 1 1 
1 0 0 6 1 0 0 0 0 0 1 1 
1 1 1 1 1 1 1 1 1 0 1 1 
1 0 0 0 0 0 0 0 0 0 1 1 
1 0 0 0 0 0 0 0 0 2 1 1 
1 0 0 0 0 0 0 5 0 0 1 1 
1 0 0 0 0 0 0 0 0 0 1 1 
1 0 0 0 0 0 0 0 0 0 1 1 
1 0 0 0 0 0 0 0 0 0 3 1 
1 0 0 0 0 0 0 5 0 0 3 1 
1 0 0 0 0 0 0 0 0 0 3 1 
1 0 0 0 0 0 0 0 0 0 3 1 
1 0 0 0 0 0 0 0 0 0 1 1 
1 0 0 0 0 0 0 0 0 0 1 1 
1 0 0 0 0 0 0 5 0 2 1 1 
1 0 0 0 0 0 0 0 0 0 1 1 
1 0 0 0 0 0 0 0 0 0 1 1 
1 0 0 0 0 0 0 0 0 0 3 1 
1 0 0 4 0 0 0 0 0 0 3 1 
1 0 0 0 0 0 0 5 0 0 3 1 
1 0 0 0 0 0 0 0 0 0 3 1 
1 0 0 4 0 0 0 0 0 0 1 1 
1 0 0 0 0 0 0 0 0 0 1 1 
1 0 0 0 0 0 0 0 0 0 1 1 
1 0 0 4 0 0 0 0 0 0 1 1 
1 0 0 0 0 0 0 5 0 0 1 1 
1 0 0 0 0 0 0 0 0 2 1 1 
1 0 0 4 0 0 0 0 0 0 1 1 
1 1 1 1 1 1 1 1 1 0 1 1 
1 0 0 1 1 0 0 0 0 0 1 1 
1 0 6 0 0 0 0 1 1 1 1 1 
1 0 0 0 1 1 0 0 0 0 1 1 
1 1 1 1 1 1 1 1 1 0 1 1 
1 0 0 0 0 0 0 0 0 0 1 1 
1 0 0 0 0 0 0 0 0 0 1 1 
1 0 0 0 0 0 0 0 0 0 1 1 
1 0 0 0 0 0 0 0 0 0 1 1 
1 0 0 0 0 0 0 5 0 1 1 1 
1 0 0 0 0 0 0 0 0 0 1 1 
1 0 0 0 5 0 1 0 0 0 1 1 
1 0 0 0 0 0 0 0 0 0 1 1 
1 0 5 1 1 1 1 1 1 1 1 1 
1 0 0 0 0 0 0 0 0 0 1 1 
1 0 0 0 5 0 1 0 0 0 1 1 
1 0 0 0 0 0 0 0 0 0 1 1 
1 0 0 0 0 0 0 5 0 1 1 1 
1 0 0 0 0 0 0 0 0 0 1 1 
1 0 0 0 0 0 0 0 0 0 1 1 
1 0 4 0 0 0 4 0 0 0 1 1 
1 0 0 0 0 0 0 0 0 0 1 1 
1 0 0 0 4 0 0 0 4 0 1 1 
1 0 0 0 0 0 0 0 0 0 1 1 
1 0 0 0 0 0 0 1 0 0 1 1 
1 0 0 0 0 5 2 1 0 5 3 1 
1 0 0 0 0 0 0 1 0 0 1 1 
1 0 5 2 1 0 0 0 0 0 3 1 
1 0 0 0 1 0 0 0 0 2 1 1 
1 0 0 0 0 0 0 1 0 0 1 1 
1 0 0 0 0 5 2 1 0 5 3 1 
1 0 0 0 0 0 0 1 0 0 1 1 
1 0 0 2 1 0 0 0 0 2 1 1 
1 0 5 0 1 0 0 0 0 0 3 1 
1 0 0 0 0 0 0 1 0 0 1 1 
1 0 0 0 0 5 2 1 0 5 3 1 
1 0 0 0 0 0 0 1 0 0 1 1 
1 0 0 0 0 0 0 0 0 0 1 1 
1 0 0 0 0 0 0 0 0 0 1 1 
1 0 0 0 0 0 0 0 0 0 1 1 
1 0 0 0 0 0 0 0 0 0 1 1 
1 0 1 1 1 1 1 0 0 5 0 0 
1 0 1 0 1 1 0 0 0 0 1 1 
1 0 1 1 1 0 1 0 0 5 0 0 
1 0 0 0 0 0 0 0 0 0 1 1 
1 0 1 1 1 1 1 0 0 5 0 0 
1 0 0 0 0 0 1 0 0 0 1 1 
1 0 1 1 1 1 1 0 0 5 0 0 
1 0 0 0 0 0 0 0 0 0 1 1 
1 0 1 1 1 1 1 0 0 5 0 0 
1 0 0 1 0 0 0 0 0 0 1 1 
1 0 0 0 1 0 0 0 0 5 0 0 
1 0 0 0 0 1 0 0 0 0 1 1 
1 0 1 1 1 1 1 0 0 5 0 0 
1 0 0 0 0 0 0 0 0 0 1 1 
1 0 0 0 0 0 0 0 0 0 1 1 
1 0 0 0 0 0 5 0 0 0 1 1 
1 0 0 0 0 0 0 1 0 0 0 0 
1 0 0 0 0 0 0 0 0 0 0 0 
1 0 0 0 0 5 0 0 0 0 0 0 
1 0 0 0 0 0 0 0 0 0 1 1 
1 0 0 0 0 1 0 0 0 1 1 1 
0 0 0 0 0 0 0 0 0 0 1 1 
0 0 0 5 0 0 0 0 0 0 0 0 
0 0 0 0 0 0 0 0 0 0 0 0 
0 0 0 0 0 0 0 0 0 0 0 0 
0 0 0 5 0 0 0 0 0 0 0 0 
0 0 0 0 1 0 0 0 0 0 1 1 
0 0 0 0 0 0 0 0 0 1 1 1 
0 0 5 0 0 0 0 0 0 0 1 1 
0 0 0 0 0 0 0 0 0 0 0 0 
0 0 0 0 0 0 0 0 0 0 0 0 
0 0 0 0 5 0 0 0 0 0 0 0 
0 0 0 0 0 0 0 0 0 0 0 0 
1 0 0 0 0 0 1 0 0 0 0 0 
1 0 0 0 0 0 1 0 0 0 1 1 
1 0 0 0 7 0 1 1 1 1 1 1 
1 0 0 0 0 0 1 0 0 0 1 1 
1 1 1 1 1 1 1 1 1 1 1 1 
